WE	./textures/bluestone.xpm
NO	./textures/redbrick.xpm
F   5,   40,     5
EA	./textures/purplestone.xpm
SO	./textures/greystone.xpm
C   10, 120 , 255

 1111111111111111111111
100000000000W00000000001
 1000000000000000000001
  10000000000000000001
   100000010000000001
    10000011010000001
     100001000000011
      100000000001
       1000000001
        10000001
         100001
          1001
           111






