WE	./textures/bluestone.xpm
NO	./textures/redbrick.xpm
F   5,   40,     5
EA	./textures/purplestone.xpm
SO	./textures/greystone.xpm
C   10, 120 , 255

111111111111
110000000S0111
111110111111
1111101111111111
1100000000000011
11111111111101111
1111111111110111
1110000000000011111
1110010000000011111
1110001000000011111
1110000100000011111
1110000010000011111
1110011111000011111
1110111111111011111
11101111111110000111111
111001111111101111100011
11110111111111111111011
11110000000000000000011
11111110111111111111111
111111101111
11000000000111
111110111111
1111101111111111
1100000000000011
11111111111101111
1111111111110111
1110000000000011111
1110010000000011111
1110001000000011111
1110000100000011111
1110000010000011111
1110011111000011111
1110111111111011111
11101111111110000111111
111001111111101111100011
11110111111111111111011
11110000000000000000011
11111111111111111111111