



WE 	./textures/Asset-11.xpm



F   37, 89,  47



NO	./textures/Asset-7.xpm


EA	                                ./textures/Asset-15.xpm             

SO	./textures/Asset-9.xpm
C   0,   42     			,     133	
    
    0
     
1111111111111111111111111111110
 10000011101110111110111100011111      111
110000000001000001000011100000001     10111
 1000001110100011111010000W011111     11111
1111111111111111 111111111111
