WE	./textures/bluestone.xpm
NO	./textures/redbrick.xpm
F   230,   42,     78
EA	./textures/purplestone.xpm
SO	./textures/greystone.xpm
C   1, 37 , 190

111111
100001
10N001
100001
111111