WE	./textures/bluestone.xpm
NO	./textures/redbrick.xpm
F   5,   40,     5
EA	./textures/purplestone.xpm
SO	./textures/greystone.xpm
C   10, 120 , 255

111111111111111111111
100000000000000000001
100000010000000000001
100000000000000000001
100000000000N00000001
100000010000000000001
100000000000000000001
100000000000000000001
111111111111111111111



