WE	./textures/bluestone.xpm
NO	./textures/redbrick.xpm
F   230,   42,     78
EA	./textures/purplestone.xpm
SO	./textures/greystone.xpm
C   1, 37 , 190

111111111111111111111
100000000000000000001
100000010000000000001
100000000000000000001
100000000000000000001
100000010000000000001
100000000000000000001
10000000E000000000001
111111111111111111111