WE	./textures/bluestone.xpm
NO	./textures/redbrick.xpm
F   0,   42,     133
EA	./textures/eagle.xpm
SO	./textures/greystone.xpm
C   78,100,255

 1111111111111111111111
100000000000000000000001
 1000000000000000000001
  10000000000000000001
   100000000000000001
    1000000000000001
     10000000000001
      1000000000N1
       1000000001
        10000001
         100001
          1001
           111
           11