WE	./textures/bluestone.xpm
NO	./textures/redbrick.xpm

whateverrrrrrrrrrr

ne.xpm
C   10, 120 , 255

111111111111111111111
100000000000000000001
100000010000000000001
100000000000000000001
100000000000W00000001
100000010000000000001
100000000000000000001
100000000000000000001
111111111111111111111